6 6
+   +---+---+---+---+---+
|       |               |
+---+   +---+---+---+   +
|   |               |   |
+   +---+---+---+   +   +
|           |   |       |
+   +---+   +   +---+   +
|   |               |   |
+   +---+---+---+---+   +
|           |           |
+   +---+   +   +---+---+
|       |               |
+---+---+---+---+---+   +
15
0,0
1,0
1,1
2,1
3,1
4,1
4,2
5,2
5,3
5,4
4,4
3,4
3,5
4,5
5,5
31
22
