4 4
+   +---+---+---+
|       |       |
+---+   +---+   +
|   |           |
+   +---+---+   +
|               |
+   +---+---+---+
|               |
+---+---+---+   +
13
0,0
1,0
1,1
2,1
3,1
3,2
2,2
1,2
0,2
0,3
1,3
2,3
3,3
16
16
