8 8
+   +---+---+---+---+---+---+---+
|       |                   |   |
+---+   +---+---+---+   +   +   +
|   |               |   |       |
+   +---+---+---+   +   +---+   +
|       |       |       |       |
+   +   +   +   +---+---+   +---+
|   |       |   |           |   |
+   +---+---+---+   +---+---+   +
|                   |       |   |
+   +---+---+---+---+   +   +   +
|   |           |       |   |   |
+   +   +---+   +   +---+   +   +
|   |   |   |   |   |       |   |
+   +   +   +   +   +   +---+   +
|       |           |           |
+---+---+---+---+---+---+---+   +
45
0,0
1,0
1,1
2,1
3,1
4,1
4,2
5,2
5,1
5,0
6,0
6,1
7,1
7,2
6,2
6,3
5,3
4,3
4,4
3,4
2,4
1,4
0,4
0,5
0,6
0,7
1,7
1,6
1,5
2,5
3,5
3,6
3,7
4,7
4,6
4,5
5,5
5,4
6,4
6,5
6,6
5,6
5,7
6,7
7,7
50
60
