10 10
+   +---+---+---+---+---+---+---+---+---+
|       |       |       |       |       |
+---+   +---+   +   +---+   +---+   +---+
|   |               |       |           |
+   +---+---+   +   +   +---+---+---+   +
|           |   |               |       |
+---+   +   +   +   +---+---+---+---+   +
|       |   |   |                   |   |
+   +---+   +   +---+   +---+---+   +   +
|   |       |       |   |               |
+---+   +---+   +---+---+---+---+---+---+
|   |                       |           |
+   +---+   +---+---+   +---+   +---+---+
|       |   |   |           |       |   |
+---+   +   +   +---+---+   +   +   +   +
|       |   |                   |       |
+   +---+   +---+   +   +---+---+---+   +
|               |   |       |           |
+   +---+   +---+---+---+   +---+---+   +
|       |       |           |           |
+---+---+---+---+---+---+---+---+---+   +
21
0,0
1,0
1,1
2,1
3,1
3,2
3,3
3,4
3,5
4,5
5,5
5,6
6,6
6,7
7,7
7,6
8,6
8,7
9,7
9,8
9,9
96
97
